..###....
#.#.#.#.#
.........
.##.####.
.#..#....
#..#..#.#
F.##S##..